#########
#~~.....#
#~......#
#.......#
#########
