#########
#~~.....#      #####
#~.................#
#.......#      #...#
#########      #...#
               #####
